33,39
60
40
5000
@a@a@a@a@a@a@a@a@a@a@a@a@a@a@a@a@a@a@a@
@a@a@a@a@a@a@a@a@a@a@a@a@a@a@a@a@a@a@a@
@a@a@a@a@a@a@a@a@a@a@a@a@a@a@a@a@a@a@a@
@a@a@a@a@a@a@a@a@a@a@a@a@a@a@a@a@a@a@a@
@a@a@a@a@a@a@a@a@a@a@a@a@a@a@a@a@a@a@a@
@a@a@a@a@a@a@a@a@a@a@a@a@a@a@a@a@a@a@a@
@a@a@a@a@a@a@a@a@a@a@a@a@a@a@a@a@a@a@a@
@a@a@a@a@a@a@a@a@a@a@a@a@a@a@a@a@a@a@a@
@a@a@a@a@a@a@a@a@a@a@a@a@a@a@a@a@a@a@a@
@a@a@a@a@a@a@a@a@a@a@a@a@a@a@a@a@a@a@a@
@a@a@a@a@a@a@a@a@a@a@a@a@a@a@a@a@a@a@a@
@a@a@a@a@a@a@a@a@a@a@a@a@a@a@a@a@a@a@a@
@a@a@a@a@a@a@a@a@a@a@a@a@a@a@a@a@a@a@a@
@a@a@a@a@a@a@a@a@a@a@a@a@a@a@a@a@a@a@a@
@a@a@a@a@a@a@a@a@a@a@a@a@a@a@a@a@a@a@a@
@a@a@a@a@a@a@a@a@a@a@a@a@a@a@a@a@a@a@a@
@a@a@a@a@a@a@a@a@a@a@a@a@a@a@a@a@a@a@a@
@a@a@a@a@a@a@a@a@a@a@a@a@a@a@a@a@a@a@a@
@a@a@a@a@a@a@a@a@a@a@a@a@a@a@a@a@a@a@a@
@a@a@a@a@a@a@a@a@a@a@a@a@a@a@a@a@a@a@a@
.......................................
.......................................
.......................................
.......................................
.......................................
@o@@o@@o@@o@@o@@o@@i@@i@@i@@i@@i@@i@@i@
@o@@o@@o@@o@@o@@o@@i@@i@@i@@i@@i@@i@@i@
@o@@o@@o@@o@@o@@o@@i@@i@@i@@i@@i@@i@@i@
@o@@o@@o@@o@@o@@o@@i@@i@@i@@i@@i@@i@@i@
@o@@o@@o@@o@@o@@o@@i@@i@@i@@i@@i@@i@@i@
@r@@r@@r@@r@@r@@r@@r@@r@@r@@r@@r@@r@@r@
@r@@r@@r@@r@@r@@r@@r@@r@@r@@r@@r@@r@@r@
@r@@r@@r@@r@@r@@r@@r@@r@@r@@r@@r@@r@@r@